###############################
##                         ####
##                         ####
##                          ##
#######                   #####
##                         ####
#                             #
############# #################

###############################
